//tileWidth tileHeight howManyMaps; nxtMapSymbol; nameOfZone; Zl7,l mapWidth mapHeight
32 32 8
+
Town
0 19 20
4,4,4,4,5,4,4,4,4,4,4,4,4,4,4,4,4,4,5,4,
4,3,3,3,3,4,2,2,2,0,0,2,2,2,3,3,3,8,3,4,
4,3,3,3,3,4,2,2,3,3,3,3,2,2,3,2,2,4,7,4,
4,4,4,4,3,4,2,2,3,3,3,3,2,2,3,3,3,4,4,4,
4,2,2,3,3,3,2,2,2,0,0,2,2,2,3,3,3,3,3,4,
4,4,4,3,4,3,3,3,3,3,3,3,3,3,3,3,3,3,3,4,
4,3,3,3,4,2,2,2,2,2,2,2,2,2,3,3,3,3,3,4,
4,3,3,3,4,2,2,2,2,4,2,2,2,2,3,3,3,3,2,4,
4,4,4,4,3,4,2,2,3,3,3,3,2,2,3,3,3,4,4,4,
4,2,2,3,3,3,2,2,2,0,0,2,2,2,3,3,3,3,3,4,
4,4,4,3,4,3,3,3,3,3,3,3,3,3,3,3,3,3,3,4,
4,3,3,3,4,2,2,2,2,2,2,2,2,2,3,3,3,3,3,4,
4,3,3,3,4,2,2,2,2,4,2,2,2,2,3,3,3,3,2,4,
4,3,3,3,4,2,2,2,2,2,2,2,2,2,2,2,3,3,2,4,
4,4,4,3,4,3,3,3,3,3,3,3,3,3,3,3,3,3,3,4,
4,3,3,3,4,2,2,2,2,2,2,2,2,2,3,3,3,3,3,4,
4,3,3,3,4,2,2,2,2,4,2,2,2,2,3,3,3,3,2,4,
4,3,3,3,4,2,2,2,2,2,2,2,2,2,2,2,3,3,2,4,
4,4,4,4,4,4,5,4,4,4,4,4,4,4,4,4,4,4,4,4,
+
Dungeon 1
1 14 34
4,4,4,4,4,4,4,4,4,4,4,5,4,4,4,4,4,4,4,4,4,4,4,4,4,4,4,4,4,4,5,4,4,4,
4,1,1,1,1,1,1,1,1,1,1,1,1,1,1,1,1,4,6,4,1,1,1,1,1,1,1,1,1,1,1,1,1,4,
4,1,4,4,4,4,4,1,1,1,1,1,1,1,1,1,1,4,3,4,4,1,1,1,1,1,1,1,1,1,1,1,1,4,
4,1,4,1,1,1,1,1,1,1,1,1,1,1,4,4,4,4,3,4,4,4,1,1,1,1,1,1,1,1,1,1,1,4,
4,1,4,7,4,4,4,4,4,4,1,4,4,4,4,1,1,1,3,1,1,1,1,1,4,4,4,1,1,1,4,1,1,4,
4,1,4,5,4,4,4,1,1,1,1,4,1,1,1,1,1,4,3,4,1,1,1,1,1,1,1,1,1,1,4,1,1,4,
4,1,1,1,4,1,1,1,1,1,1,4,1,1,1,1,1,1,3,4,4,4,4,4,1,1,1,1,1,1,4,4,1,4,
4,1,1,1,4,1,1,1,1,1,1,4,4,4,4,4,4,1,3,1,1,1,1,1,1,1,1,4,1,1,1,1,1,4,
4,1,1,1,1,1,4,4,4,4,4,4,1,1,1,1,1,1,1,1,1,1,1,1,1,1,1,1,1,1,4,1,4,4,
4,1,1,1,1,1,1,1,1,1,1,4,1,1,1,1,1,1,1,4,4,4,4,1,4,1,1,1,1,1,4,1,1,4,
4,1,1,1,1,1,1,1,1,1,1,4,1,1,1,1,1,1,1,4,1,1,1,1,4,4,4,4,4,4,4,4,4,4,
4,1,1,1,1,1,1,1,1,1,1,4,4,4,4,4,5,4,4,4,4,1,4,4,4,1,1,1,1,1,1,1,1,4,
4,1,1,1,1,1,1,1,1,1,1,1,1,1,1,1,1,1,1,1,1,1,1,1,1,1,1,1,1,1,1,1,1,4,
4,4,4,4,4,4,4,4,4,4,4,4,4,4,4,4,4,4,4,4,4,4,4,4,4,4,4,4,4,4,4,4,4,4,
+
Dungeon 2
2 11 41
4,4,4,4,4,4,4,4,4,4,4,4,4,4,4,4,4,4,4,4,5,4,4,4,4,4,4,4,4,4,4,4,4,4,4,4,4,4,4,4,4,
4,1,1,1,4,1,1,1,1,1,1,1,1,1,1,1,1,1,1,1,1,1,4,4,4,1,1,1,1,1,1,4,1,1,1,1,1,1,1,1,4,
4,1,4,4,4,7,4,1,1,1,1,1,1,1,1,1,1,1,4,4,4,4,4,1,1,1,1,1,4,1,1,1,1,1,1,4,1,1,1,1,4,
4,1,4,6,4,5,4,1,1,4,4,1,1,1,1,1,1,1,1,1,1,1,1,1,4,4,4,4,4,4,4,4,4,1,4,4,4,1,4,4,4,
4,1,1,1,1,1,4,1,1,1,1,1,1,1,1,1,1,1,4,1,1,1,1,1,4,1,1,1,1,1,1,1,1,1,1,1,1,1,1,1,4,
4,1,1,1,1,1,4,4,4,4,4,4,4,4,4,4,4,4,4,4,4,5,4,4,4,1,1,1,1,1,1,1,1,4,1,1,4,4,1,1,4,
4,1,1,1,1,1,1,1,4,1,1,1,1,1,1,1,1,1,1,1,1,1,1,1,4,1,1,1,1,1,1,1,1,1,1,1,1,1,1,1,4,
4,1,1,1,1,1,1,1,4,1,1,1,1,1,1,1,1,1,1,1,1,1,1,1,4,1,1,1,1,4,1,1,4,4,1,1,4,4,1,1,4,
4,1,1,1,1,1,1,1,1,1,1,1,1,1,1,1,1,1,1,1,1,1,1,1,5,4,1,1,4,4,1,1,4,4,1,1,4,4,1,1,4,
4,1,1,1,1,1,1,1,4,1,1,1,1,1,1,1,1,1,1,1,1,1,1,1,1,1,1,1,1,1,1,1,1,1,1,1,1,1,1,1,4,
4,4,4,4,4,4,4,4,4,4,4,4,4,4,4,4,4,4,4,4,4,4,4,4,4,4,4,4,4,4,4,4,4,4,4,4,4,4,4,4,4,
+
Dungeon 3
3 15 21
4,4,4,5,4,4,4,4,4,4,4,4,4,4,4,4,4,4,4,4,4,
4,1,1,1,4,6,4,1,1,1,1,1,1,1,4,1,1,1,1,1,4,
4,1,1,4,1,1,1,4,1,1,4,4,1,1,4,1,1,4,7,4,4,
4,1,1,4,1,1,4,1,1,4,1,1,1,1,4,1,1,4,4,1,4,
4,1,1,1,4,1,1,1,4,1,1,1,1,1,4,1,1,1,1,1,4,
4,1,4,1,1,4,4,4,1,1,4,4,4,4,4,4,4,4,1,4,4,
4,1,1,4,1,1,1,1,1,1,1,1,1,1,4,1,1,1,1,1,4,
4,1,1,4,4,4,4,5,4,4,4,4,4,4,4,1,1,1,1,4,4,
4,1,1,1,1,1,1,1,1,1,1,1,1,1,4,1,1,1,1,1,4,
4,1,1,1,1,1,1,1,1,1,1,1,1,1,4,1,1,1,1,1,4,
4,1,1,1,1,1,1,1,1,4,1,1,1,1,4,1,1,1,1,1,4,
4,1,1,1,1,1,1,1,1,4,1,1,1,1,4,1,4,4,4,1,4,
4,1,1,1,1,1,1,1,1,1,1,1,1,1,4,1,1,1,1,1,4,
4,1,1,1,1,1,1,1,1,1,1,1,1,1,1,1,1,1,1,1,4,
4,4,4,4,4,4,4,4,4,4,4,4,4,4,4,4,4,4,4,4,4,
+
Dungeon 4
4 10 20
4,4,4,5,4,4,4,4,4,4,4,4,4,4,4,4,4,4,4,4,
4,1,1,1,1,1,1,1,1,1,1,1,1,1,1,1,1,4,6,4,
4,7,4,4,4,4,4,4,4,4,4,4,1,1,1,1,4,1,1,4,
4,4,4,1,1,1,1,1,1,1,1,1,1,1,1,4,1,1,1,4,
4,1,1,1,4,4,4,4,4,4,4,4,4,4,4,1,1,1,1,4,
4,1,1,1,1,1,1,5,1,1,1,1,1,1,1,1,1,1,1,4,
4,1,1,1,4,4,1,1,1,4,4,4,4,1,4,4,4,4,4,4,
4,1,1,4,1,1,4,1,4,1,1,4,1,1,1,1,1,1,1,4,
4,1,1,4,1,1,1,1,1,1,1,4,1,1,1,1,1,1,1,4,
4,4,4,4,4,4,4,4,4,4,4,4,4,4,4,4,4,4,4,4,
+
Dungeon 5
5 10 20
4,4,4,4,4,4,4,4,4,4,4,4,4,4,4,4,4,4,4,4,
4,6,4,1,1,1,1,1,1,1,1,1,1,1,1,1,1,1,1,4,
4,1,4,4,4,4,4,4,4,4,1,4,5,4,1,4,4,1,1,4,
4,1,1,1,1,1,1,1,1,4,1,1,1,1,4,1,1,1,1,4,
4,1,1,1,1,1,1,1,1,1,4,1,1,1,4,1,1,1,1,4,
4,4,4,4,4,4,1,1,1,1,4,1,1,1,4,1,1,1,1,4,
4,1,1,1,1,4,1,1,1,1,4,1,1,1,4,1,1,4,4,4,
4,1,1,1,1,1,1,1,4,4,5,4,1,1,4,1,1,1,1,4,
4,1,1,1,1,4,1,1,1,1,1,1,1,1,4,1,1,4,7,4,
4,4,4,4,4,4,4,4,4,4,4,4,4,4,4,4,4,4,4,4,
+
Dungeon 6
6 14 20
4,4,4,4,4,4,4,4,4,4,4,4,4,4,4,4,4,4,4,4,
4,1,1,1,1,1,1,1,1,1,1,1,1,1,1,4,1,1,1,4,
4,1,1,1,1,1,1,4,1,1,1,1,1,1,1,1,1,1,1,4,
4,4,4,4,1,4,4,4,4,4,4,1,4,4,4,4,1,1,1,4,
4,1,1,1,1,1,1,1,4,1,1,1,1,1,4,1,1,1,1,4,
4,1,1,1,1,1,1,1,4,1,1,1,1,1,4,1,1,1,1,4,
4,1,1,1,1,1,4,4,5,4,4,4,4,4,4,1,1,4,4,4,
4,1,1,1,1,1,1,1,1,1,1,1,1,1,4,1,1,4,6,4,
4,1,1,1,1,1,1,1,4,7,4,1,1,1,4,1,1,1,1,4,
4,1,1,1,1,1,1,4,1,1,1,1,1,1,1,1,1,1,1,4,
4,1,1,1,1,1,1,4,1,1,1,1,1,1,1,1,1,1,1,4,
4,1,1,1,1,1,1,4,1,1,1,1,1,1,1,1,1,1,1,4,
4,1,1,1,1,1,1,4,1,1,1,1,1,1,1,1,1,1,1,4,
4,4,4,4,4,4,4,4,4,4,4,4,4,4,4,4,4,4,4,4,
+
Dungeon 7
7 10 23
4,4,4,4,4,4,4,4,4,4,5,4,4,4,4,4,4,4,4,4,4,4,4,
4,1,1,1,1,1,1,1,1,1,1,1,1,1,1,1,4,4,1,1,1,1,4,
4,1,1,1,1,1,1,4,1,1,1,1,1,1,1,1,4,4,1,1,1,1,4,
4,1,1,1,4,4,4,5,1,1,1,1,1,1,1,1,1,1,1,1,1,1,4,
4,4,1,1,4,1,1,1,1,1,1,4,4,4,4,4,4,4,4,1,1,4,4,
4,1,1,1,4,4,1,1,1,1,1,1,1,1,1,1,1,1,1,1,1,1,4,
4,1,1,1,1,1,1,4,4,4,4,4,1,1,1,1,4,4,4,4,1,1,4,
4,1,1,1,4,1,1,1,4,6,4,1,1,4,1,4,1,1,1,1,4,1,4,
4,1,1,1,1,4,1,1,1,1,1,1,1,1,1,1,1,1,1,1,1,1,4,
4,4,4,4,4,4,4,4,4,4,4,4,4,4,4,4,4,4,4,4,4,4,4,